#################### #############################
#                              ###################
########### ######################################
########### ######################################
#                                                #
########### ######################################
########### ######################################
#                                                #
########### ######################################
########### ######################################
########### ######################################
###########                                      #
############### ##### ######## ########## ########
#           ### ##### ##    ## ########## ########
########### ### ##### ## ## ## ########## ########
########### ### ##### ##### ## ########## ########
########### ###   ###       ## ###        ########
########### ##### ################################
###########                    ###################
############################## ###################